0000000000
0011000000
0001000000
0001000000
0001000000
0001111110
0000000100
0000000100
1111110000
0000000000