0000000000
0000100000
0000000000
0100000010
0100000010
0000000010
0000000010
0111111110
0000000000
0000000000