0000000000
0000000000
0000100000
0011110000
0110011100
8100010008
1100000000
0000000000
0000000000
0000000000