0000000000
0010000000
0010000000
0010000000
0010001000
0011101000
0010001000
0010001000
0000001000
0010000000