0000000000
0010100000
0010100000
0010100000
0010100000
0011100000
0000000000
0000000000
0000000000
0000000000