0000000000
0000000000
1110001110
0010001010
0010001000
0010001000
0010001000
0010001000
0011101000
0000001000