0000000000
0000100000
0111111110
0100000010
0100000010
0000000000
0111111111
0000111111
0000100000
0000000000